######## # ########
#*.......#.......*#
#.#-#.##.#.##.#-#.#
#.-B-.........-I-.#
#.#-##.#####.##-#.#
#........#........#
#.#.####.#.####.#.#
#.#....#.#.#....#.#
#.#.##.#.#.#.##.#.#
 ........&........ 
#.#.####.#.####.#.#
#.#.#....#....#.#.#
#.#.#.##.#.##.#.#.#
#........#........#
#.#-#.#######.#-#.#
#.-C-.........-P-.#
#.#-#.##.#.##.#-#.#
#*.......#.......*#
######## # ########
