# ############### #
 ................. 
#.#.###.#.#.###.#.#
#.*.#...#.#...#.*.#
#.#.#.#.#.#.#.#.#.#
#.................#
#.######.#.######.#
#..#I#.......#B#..#
##.#-# ## ## #-#.##
  .      &      .  
##.#-# ## ## #-#.##
#..#P#.......#C#..#
#.##### #.# #####.#
#.......#.#.......#
#.#.#.#.#.#.#.#.#.#
#.#.*.#.....#.*.#.#
#.###.#.#.#.#.###.#
 ................. 
# ############### #
