###################
#........#........#
#.##.###.#.###.##.#
#*...............*#
#.##.#.#####.#.##.#
#....#...#...#....#
####.### # ###.####
   #.#   B   #.#   
####.# ##-## #.####
    .  -IPC-  .    
####.# ##-## #.####
   #.#       #.#   
####.### # ###.####
#....#...#...#....#
#.##.#.#####.#.##.#
#*.......&.......*#
#.##.###.#.###.##.#
#........#........#
###################
