###################
#........#........#
#.##.###.#.###.##.#
#.................#
#.##.#.#####.#.##.#
#....#...#...#....#
#.##.### # ###.##.#
 .*#.    B    .#*  
#.##.# ##-## #.##.#
 .  .  -IPC-  .  . 
#.##.# ##-## #.##.#
 .*#.         .#*. 
#.##.### # ###.##.#
#....#...#...#....#
#.##.#.#####.#.##.#
#........&........#
#.##.###.#.###.##.#
#........#........#
###################
