#########.######.##
#&#B#...#.........#
#.# #.#.#.#### ##.#
#.# #.#.#.###...#.#
#.# #.#.#...#.#.#.#
#.# #.#.###.#...#.#
#.# #.#...#.###*#.#
#.# #.###.#...###.#
#.# #...#.#.#.....#
#.#-###.#.#.#####-#
.*......#.#.....#..
#####-#.#.###.#.#.#
#...#P#.......#*#.#
#.#.#####-###.#.#I#
#.#......C..#.#.#.#
#.#########.#...#.#
#.#########.#####.#
#.................#
#########.######.##
